00000000000000000000
00000000000000000000
00000000000000000000
00000000070000000000
00000000222000000008
00000000000000000222
00000000000005000000
00000300000000000000
00022222000000000000
00000000000000000000
00000000000000000000
00000000000040000000
00000000000000000070
00000000000000000022
00000000000000000000
00000700000220000000
00022220000000000000
00011110000000000000
00011110000000000000
22211116666666666666