00000000000000000000
00000000000000000000
00000000000000000000
80000070000070000000
2220000000000000000
11100040000040000000
11166666666666622000
11111111111111111000
11111111111111111000
00000000000000000007
00000000000000000002
00000000000000000000
00000000000000000020
00000000000000000000
00000000000070000500
00000000003000300000
00000000022222220000
00022000011111110000
00211200000000000000
22111122222222222222