00000000000000000000
00000000000000000000
00000700000000000008
00000200000700000222
00000000002207050000
00000000500022000000
07002220000000000000
02000000000000000000
00000000000700700000
00200707000000000000
00022040000300300000
00000000022222220000
00000000000000000000
00000000007070000200
00000000000000000000
00000000002020222222
00000022266666111111
00000211111111111111
00002111111111111111
22221111111111111111 


